55555555555555555555555
50000000500000000000005
50020000001234567898765
55535555500000000000000
50000000500003000000005
50000000000000000000005
50000000500000000000005
55555555555555555555555