55555555555555555555555
50000000500000000000005
50020000001234567898769
55535555500000000990000
500000005  003009990005
5000000000 009999990005
50000000599999999990005
55555555555555555555555